10,0,0,0,2,0,1,0,0,2,0,2,0,0,2,0,0,1,0,2,0,1,1,0,2,0,2,1,0,1,0,0,2,0,2,0,1,2,0,2,0,2,2,0,2,0,1,1,1,0,1
12,0,0,0,2,0,1,0,0,2,0,1,-1,0,2,0,0,-1,0,2,0,1,1,0,2,0,2,1,0,2,0,2,2,0,2,0,1,2,0,2,0,0,3,0,2,0,1,3,0,2,0,1,0,1,0,1,0,2,0,1,0
10,0,0,0,1,0,0,1,0,3,0,1,1,0,3,0,1,0,0,3,0,1,0,1,0,1,2,1,0,3,1,2,0,0,3,1,0,-1,0,3,1,1,-1,0,3,1,2,-1,0,3,1
8,0,0,0,2,0,1,0,0,2,0,2,0,0,2,0,3,0,0,2,0,3,-1,0,2,0,2,-1,0,2,0,1,-1,0,1,0,2,-1,1,0,1
34,0,0,0,2,0,1,0,0,2,0,-1,0,0,2,0,0,1,0,2,0,0,2,0,2,0,0,3,0,2,0,0,4,0,2,0,0,5,0,1,0,-1,5,0,1,0,1,5,0,1,0,1,4,0,2,0,-1,4,0,2,0,-1,-1,0,2,0,0,-1,0,2,0,1,-1,0,2,0,0,-2,0,2,0,-1,-2,0,2,0,1,-2,0,2,0,0,-1,1,0,1,0,-2,1,0,1,0,-3,1,0,1,0,-3,0,2,0,-1,-3,0,2,0,1,-3,0,2,0,2,-3,0,2,0,2,-2,0,2,0,2,-1,0,2,0,2,0,0,2,0,-1,-4,0,2,0,0,-4,0,2,0,1,-4,0,2,0,2,-4,0,2,0,1,3,0,2,0,-1,3,0,2,0


